00000000000000000000000000000
01111111111111110111111111110
01111111111111110111111111110
00010000000000000111111111110
00010000000000000111111111110
01111111111111110111111111110
01111111111111110110000000010
01111111111111110111011111110
01111111111111111111011111110
01110000000100000111011111110
01110111111111110111011111110
01110111111111110111011111110
01110111111111110111111111110
01110111111111111111011111110
01111111111111111000000000000
01110111111111111111111111110
01110111111111110111111111110
01110000000100000000000000000
01110111111111110
01111111111111110
01110111111111110
01110000000100000
01110111111111110
01110111111111110
01111111111111110
01110111111111110
11110111111111110
01110111111111110
00000000000000000