00000000000000000000000000000
01111111111111110111111111110
01111111111111110111111111110
00010000000000000111111111110
   1       000000
01111111111111110111011111110
01111111111        0001001001
01111111111111110111011111110
        0111011111110
00100000000000000111011111110
01110111111111110111011111110
01110111111111110111011111110
01110111111111110111111111111
01110111111111111111011111110
01111111111111111000000000000
01110111111111111111111111110
01110111111111110111111111110
01110000000000000000000000000
01110111111111110
01111111111111110
01110111111111110
01110000000000000
01110111111111110
01110111111111110
01111111111111110
01110111111111110
11110111111111110
01110111111111110
00000000000000000